F 220,100,0
NO /Users/mlagrini/Desktop/42_cub3d/north 
SO /Users/mlagrini/Desktop/42_cub3d/south
WE /Users/mlagrini/Desktop/42_cub3d/west
EA /Users/mlagrini/Desktop/42_cub3d/east

C 225,30,0

        1111111111111111111111111
        1000000000110000000000001
        1011000001110000000000001
        1001000000000000000000001
111111111011000001110000000000001
100000000011000001110111111111111
11110111111111011100N00010001
11110111111111011101010010001
11111111111111111111111111001
11111111110111111111111111111
         101
11111111110111111111111111111
1         1              1001
11111111111111111111111111001
11000000110101011100000010001
10000000000000001100000010001
10000000000000001101010010001
11000001110101011111011110N0111
11110111 1110101 101111010001
11111111 1111111 111111111111