NO ./maps/textures/sw_wall.png
SO ./maps/textures/sw2_wall.png
WE ./maps/textures/sw_wall88.png
EA ./maps/textures/sw_wallmod.png
F 192,192,192
C 158,207,255

        1111111111111111111111111
        1000000000110000000000001
        1011000001110000000000001
        1001000000000000000000001
111111111011000001110000N0000000111
100000000011000011101111100000000101
111101111111110111000000100011111111
11000000110101011100000010001
10000000000000001100000010001
10000000000000001101010010001
1100000111010101111101111000111
11110111 1110101 101111010001
11111111 1111111 111111111111
