NO ./maps/textures/north
SO ./maps/textures/south
WE ./maps/textures/west
EA ./maps/textures/east

F 220,100,0
C 225,30,0



1111111111111111111
10000000N0000000001
1000000000000000001
1000000000000000001
1000000000000000001
1000000000000000001
1111111111111111111
