


NO ./maps/textures/east.png       
SO ./maps/textures/sw_wallmod.png
WE ./maps/textures/sw2_wall.png
EA ./maps/textures/sw_wall88.png

F 192,192,192
C 158,207,255


1111111111111111111
1S00000000000000001
1000000000000000001
1000000000000000001
1000000000000000001
1000000000000000001
1111111111111111111
