F 220,100,0
C 100,30,0

NO ./maps/textures/north
SO ./maps/textures/south
WE ./maps/textures/west
EA ./maps/textures/east

1111111111111111111111111
1000000000110000100000001
1011000001110001110000001
100100000000S001010000001
1011000001110001110000001
1001000000000001010000001
1011000001110111111111111
1011000001110111111111111
1011000001110111111111111
1000000000110000100000001
1011000001110001110000001
1111111111111111111111111