
NO ./maps/textures/sw_wall6.png
SO ./maps/textures/sw_wallmod.png
WE ./maps/textures/sw2_wall.png
EA ./maps/textures/sw_wall88.png
F 220,100,0
C 100,30,0

        1111111111111111111111111
        1000000000110000100000001
111111111011000001110001110000001
100100000000S00101000000111111111
1011000001110001110000001
1001000000000001010000001
1011000001110111111111111
1011000001110111101111111
1011000001110111111111111
1011000001110111101111111
1011000001110111111111111
1011000001110111101111111
1011000001110111111111111
1011000001110111101111111
1011000001110111111111111
1011000001110111101111111
1011000001110111111111111
1011000001110111101111111
1011000001110111111111111
1011000001110111101111111
1011000001110111111111111
1011000001110111101111111
1011000001110111111111111
10110000011101111011111111111
11000000110101011100000010001
10000000000000001100000010001
10000000000000001101010010001
11000000110101011100000010001
10000000000000001100000010001
10000000000000001101010010001
11000000110101011100000010001
10000000000000001100000010001
10000000000000001101010010001
11000000110101011100000010001
10000000000000001100000010001
10000000000000001101010010001
11000000110101011100000010001
10000000000000001100000010001
10000000000000001101010010001
11000000110101011100000010001
10000000000000001100000010001
10000000000000001101010010001
10110000011101111111111111111
10000000000000001101010010001
11000000110101011100000010001
10000000000000001100000010001
10000000000000001101010010001
11000000110101011100000010001
10000000000000001100000010001
10000000000000001101010010001
10110000011101111111111111111
10000000000000001101010010001
11000000110101011100000010001
10000000000000001100000010001
10000000000000001101010010001
11000000110101011100000010001
10000000000000001100000010001
10000000000000001101010010001
10000000000000001101010010001
11000000110101011100000010001
10000000000000001100000010001
10000000000000001101010010001
11000000110101011100000010001
10000000000000001100000010001
10000000000000001101010010001
10110000011101111111111111111
10110000011101111111111111111
100000000011000011111111
1011000001110000000000001
1111111111111111111111111